NO files/images/the_rock.xpm
SO files/images/the_rock.xpm
WE files/images/the_rock.xpm
EA files/images/the_rock.xpm

F 63,155,11
C 135,206,235

111111111111111111111111111111111111111111
101000001000000000000001000001000000000001
101010101011111110000001010101011111110001
100010100010000010000000010100010000010001
111110101111101011100111110101111101011101
100000101000101000000100000101000101000001
101111101011101111110101111101011101111111
101000001010100000100101000001010100000101
101011111010111110100101011111010111110101
101010001010100010100101010001010100010101
10111010101010101010E101110101010101010101
100000101010001010000100000101010001010001
111111101011111011100111111101011111011101
100000101000100010000100000101000100010001
101110101110101110111101110101110101110111
101000100000100010100101000100000100010101
101011111111111010100101011111111111010101
100010000000000010000001010000000000010001
101010111011111111100001010111011111111101
101000001000000000000001000001000000000001
111111111111111111111111111111111111111111
