NO files/images/north.xpm
SO files/images/south.xpm
WE files/images/west.xpm
EA files/images/east.xpm

F 10,10,10
C 100,100,100

11111111111111
10000000000001
10000000000001
100N0000000001
10000000000001
10000000000001
10000000000001
10000000000001
10000000000001
10000000000001
10000000000001
10000000000001
11111111111111













1